9 9 9 9 9 1 9 1 9 9 9 9 9 9 
9 9 9 1 9 1 1 5 1 1 1 9 9 9 
9 9 1 0 1 1 0 4 1 1 1 1 9 9 
9 9 1 1 0 0 1 0 0 0 1 1 1 9 
9 1 1 0 4 0 0 0 0 0 0 1 1 1 
9 9 1 0 0 0 0 1 1 0 1 1 0 1 
9 1 0 1 0 0 0 0 0 4 0 1 1 9 
1 1 1 1 0 1 0 1 0 0 0 1 1 9 
9 9 9 1 1 3 3 3 0 0 1 1 9 9 
9 9 1 9 9 1 1 1 1 1 9 9 9 9 
9 9 9 9 9 9 9 2 2 9 9 9 9 9 
9 9 9 9 9 9 9 2 2 9 9 9 9 9 
9 9 9 9 9 9 9 2 2 9 9 9 9 9 
9 9 9 9 9 9 9 2 2 9 9 9 9 9 
9 9 9 9 9 9 9 2 2 9 9 9 9 9 
9 9 9 9 6 6 6 6 6 6 6 9 9 9 

9 9 9 9 10 10 10 10 10 10 10 10 9 9 
9 9 9 10 10 11 11 14 14 14 11 10 9 9 
9 9 10 10 11 11 11 11 14 11 10 10 9 9 
9 9 10 10 11 10 10 10 11 10 10 10 9 9 
9 9 10 11 11 11 11 11 11 10 11 10 9 9 
9 9 10 11 11 11 1 11 11 10 10 10 9 9 
9 9 10 11 11 1 1 11 11 10 10 10 9 9 
9 9 10 1 11 11 11 1 11 10 11 10 9 9 
9 9 10 11 11 1 11 12 11 10 10 10 9 9 
9 9 10 1 11 11 11 11 1 10 10 10 9 9 
9 9 10 1 11 1 11 1 1 10 11 10 9 9 
9 9 10 10 11 1 11 11 10 10 10 10 9 9 
9 9 10 11 11 12 12 11 11 10 10 10 9 9 
9 9 10 11 10 11 11 12 11 10 11 10 9 9 
9 9 10 13 11 11 10 11 11 10 10 10 9 9 
9 9 10 10 10 10 10 10 10 10 9 9 9 9 

